국명
이 부분의 본문은 한국의 나라 이름입니다.

동아시아의 한자 문화권 나라들(중국, 일본, 베트남)에서는 한국을 기원전의 고조선 왕조와 1392년에 세워진 조선 왕조에서 나온 조선(朝鮮)이라 부르며, 한반도는 조선반도(朝鮮半島)라고 한다. '한국'은 한반도이자 남북한을 말한다.

한자 문화권 외의 국가들은 한국을 커리어(Korea), 코레아(Corea) 등으로 고려라고 부른다. 이러한 이름은 한국의 고구려의 장수왕이 정한 국호인 고려(高麗)에서 나온 것으로, {{출처|날짜=2015-3-6|이미 기원전 1세기 이전부터 '고려'라는 말이 쓰였다. 10세기(918년)에 왕건이 국호를 '고려'로 정하여 나라를 세우고 그 나라의 이름이 아랍 상인들과 원나라를 통해 전해진 이후 한자 문화권 외의 국가들은 한국을 '고려'로 칭하게 되었다. 현재도 소비에트 연방(현 독립국가연합)에 사는 한민족은 고려인이라고 불린다.

    한국 (韓國) - 대한민국, 중국, 일본, 베트남에서 주로 씀.
    조선 (朝鮮) - 조선민주주의인민공화국, 중국, 일본, 베트남 에서 주로 씀.
    고려 (高麗) - 유럽, 아메리카, 러시아, 우즈베키스탄 등 구 소련 지역에서 주로 씀.

이밖에 한민족을 이르는 말로 근역 (槿域, 무궁화의 영역)과 중국의 입장에서 '동쪽에 있다'고 하여 쓰인 동국(東國), 해동(海東), 동이(東夷), 청구(靑丘, 푸른 언덕)[2], 진단 (震檀/壇)[3]등이 있다. 몽골에서는 한국을 설렁거스(Solongos, 무지개 뜨는 나라)라고 하며, 한국인을 '사돈'이라고 부른다.
다른 언어 이름
한자 문화권

    일본어:
        朝鮮 (조센)
        韓国 (칸코쿠) - 대한민국 을 말함
        北朝鮮 (키타초-센) - 조선민주주의인민공화국 을 말함
        高麗 (코-라이) - 코-레-라고도 하나 이는 거의 알타이어족모두가 사용한다.
    중국어:
        朝鲜(차오셴) - 중화인민공화국, 싱가포르 에서 사용
        韩国(한궈) - 중화인민공화국, 싱가포르 에서 대한민국으로 한정 할 때 사용
        北韓(베이한) - 중화민국, 홍콩, 마카오 등 에서 사용 (정체자)
        南韓(난한) - 중화민국, 홍콩, 마카오 등에서 사용 (정체자), 중화민국에서는 남북을 통틀어서 일컫는 의미가 될 수 있음
    베트남어:
        Triều Tiền쪠우뗸
        Hàn Quốc한꾸옥

이탈리아어파☞ㄲ로 발음

    라틴어: Coréa
    에스파냐&이탈리아어: Corea
    포르투갈어: Coreia
    루마니아어: Coreea
    프랑스어: Corée꺼레어

켈트어파

    아일랜드어: An Chóiré
    스코틀랜드 게일어: Coirea
    웨일스어: Corea

게르만&슬라브어파☞대부분 ㅋ로 발음
게르만어파

    영어:Koréa커리어(영국발음의 career와 같다.
    아이슬란드어: Kóreu

나머지는 다 Korea
슬라브어파 ja와 я는 'ㅑ' p는 'r' 발음

    러시아어: Kорея까리야☞키릴 e는 원래'ㅖ'
    불가리아어: Корея
    세르비아어: Кореја
    우크라이나어: Корея
    벨라루스어: Кoрэя э가 바로 'ㅔ'
    마케도니아어: Кореја
    폴란드어: Korea
    체코어: Korea
    슬로바키아어: Kórea
    크로아티아어: Koreja
    슬로베니아어: Koreja

인도이란어파

    힌디어: कोरिया
    네팔어: कोरिया
    벵골어: কোরিয়া
    싱할라어: කොරියාව
    페르시아어: کره
    우르두어: کوریا
    파슈토어: کوریا د

우랄어족

    헝가리어: Korea
    핀란드어: Korea

튀르크어족

    터키어: Kore
    투르크멘어: Koreya
    아제르바이잔어: Koreya

아프로아시아어족

    아랍어: كوريا
    히브리어: קוריאה
    암하라어: ኮርያ

동남아시아

    말레이어 (인도네시아어): Korea
    필리핀어: Korea
    태국어: เกาหลี까oli 중국의 高丽발음과 같다.
    라오어: ເກົາຫລີ까oli 이 크메르어에서는
    크메르어: ហាន់គុក코-레- 살짝 왜곡된다.
    버마어: ကိုရီးယား 중국어와 같은 어족이다.

인공어

    에스페란토: Koreio

기타

    일부 비주류 역사학자들은 한(韓)이라는 글자에 민족적·종교적인 어원이 있다고 말하기도 한다.[4]

